         = :   :: :    :   
         = :: ::        :  
         =   :             
         =    ::  ::       
:        =      :    @#####
 : :  SR =========== @@####
  :   R  R  S :   R=  @####
   :           ::  =  #   #
  ::         :::   =R  S#  
::  :       S   :  =  ### #
     ::   ::: S: ::========
#@@@@@ :::@@@@@@@# :: #####
####@@  ::    ####  ::    :
#####@    : : ####    : :  
######       :####    ::   
