@@@@@@@@@@@@::::##########::::@
@@@@@@@@@@@:::::=   @@@@###:@::
@@@@::@@@@::::::==:@@:@@ ##@##:
@@::@@::@@@::::::= :: :@@##@##@
@@::@@@::::::::::=  ::@@@#@##@@
::@@::@@::::::::====##:@ #@##@@
:::@@:@@@:::::::=:: ##:  #@@@@@
:::@::@@::::::::=:       #@####
:::@@::::@@::::==   ######@####
:::::::      :==   ####:@@#####
  :::       ::= : :####:@@#####
    :::    ::==::::####::@@@###
          :::=  :###::::::@@@##
           ::= ::###   ::  @@##
             =  :#     ##: ::##
             =:  # @@@@##@@@@@@
          ====  ##  @@####@@@@@
      ::: =     #   @@####@@@@@
  ::::::@:=     #  @@#####@@@@@
:::::# @@ = #####  @@####@@@###
::::## @@@= #     ::#####@#####
   ::# ##@====== @@:####@@#####
       ## = #  =  @@@@##@@#####
#   :: ==== ###== @:@@##@@## ##
##         ## # =  @:@##=@#@@##
##       ###  # == @  ##=@@@@@#
######## # #  #  ======#=@##@##
######## # #  ###     :#  #####
##################    ###@@@###
###############################
###############################
###############################
